{
    "1": 1,
    "2": 2,
    "3": 3,
    "4": 1,
    "5": 2,
    "6": 3,
    "7": 1,
    "8": 2,
    "9": 3,
    "10": 1,
    "11": 2,
    "12": 3,
    "13": 1,
    "14": 2,
    "15": 3,
    "16": 1,
    "17": 2,
    "18": 3,
    "19": 1,
    "20": 2,
    "21": 1,
    "22": 2,
    "23": 1,
    "24": 2,
    "25": 1,
    "26": 2,
    "27": 1,
    "28": 2,
    "29": 1,
    "30": 2,
    "31": 3,
    "32": 1,
    "33": 2,
    "34": 3,
    "35": 1,
    "36": 2,
    "37": 1,
    "38": 2,
    "39": 1,
    "40": 2,
    "41": 1,
    "42": 2,
    "43": 1,
    "44": 2,
    "45": 3,
    "46": 1,
    "47": 2,
    "48": 1,
    "49": 2,
    "50": 1,
    "51": 2,
    "52": 1,
    "53": 2,
    "54": 1,
    "55": 2,
    "56": 1,
    "57": 2,
    "58": 1,
    "59": 2,
    "60": 1,
    "61": 2,
    "62": 3,
    "63": 1,
    "64": 2,
    "65": 3,
    "66": 1,
    "67": 2,
    "68": 3,
    "69": 1,
    "70": 2,
    "71": 3,
    "72": 1,
    "73": 2,
    "74": 1,
    "75": 2,
    "76": 3,
    "77": 1,
    "78": 2,
    "79": 1,
    "80": 2,
    "81": 1,
    "82": 2,
    "83": 1,
    "84": 1,
    "85": 2,
    "86": 1,
    "87": 2,
    "88": 1,
    "89": 2,
    "90": 1,
    "91": 2,
    "92": 1,
    "93": 2,
    "94": 3,
    "95": 1,
    "96": 1,
    "97": 2,
    "98": 1,
    "99": 2,
    "100": 1,
    "101": 2,
    "102": 1,
    "103": 2,
    "104": 1,
    "105": 2,
    "106": 1,
    "107": 1,
    "108": 1,
    "109": 1,
    "110": 2,
    "111": 1,
    "112": 2,
    "113": 1,
    "114": 1,
    "115": 1,
    "116": 1,
    "117": 2,
    "118": 1,
    "119": 2,
    "120": 1,
    "121": 2,
    "122": 1,
    "123": 1,
    "124": 1,
    "125": 1,
    "126": 1,
    "127": 1,
    "128": 1,
    "129": 1,
    "130": 2,
    "131": 1,
    "132": 1,
    "133": 1,
    "134": 2,
    "135": 2,
    "136": 2,
    "137": 1,
    "138": 1,
    "139": 2,
    "140": 1,
    "141": 2,
    "142": 1,
    "143": 1,
    "144": 1,
    "145": 1,
    "146": 1,
    "147": 1,
    "148": 2,
    "149": 3,
    "150": 1,
    "151": 1,
    "152": 1,
    "153": 2,
    "154": 3,
    "155": 1,
    "156": 2,
    "157": 3,
    "158": 1,
    "159": 2,
    "160": 3,
    "161": 1,
    "162": 2,
    "163": 1,
    "164": 2,
    "165": 1,
    "166": 2,
    "167": 1,
    "168": 2,
    "169": 3,
    "170": 1,
    "171": 2,
    "172": 1,
    "173": 1,
    "174": 1,
    "175": 1,
    "176": 2,
    "177": 1,
    "178": 2,
    "179": 1,
    "180": 2,
    "181": 3,
    "182": 3,
    "183": 1,
    "184": 2,
    "185": 1,
    "186": 3,
    "187": 1,
    "188": 2,
    "189": 3,
    "190": 1,
    "191": 1,
    "192": 2,
    "193": 1,
    "194": 1,
    "195": 2,
    "196": 2,
    "197": 2,
    "198": 1,
    "199": 2,
    "200": 1,
    "201": 1,
    "202": 1,
    "203": 1,
    "204": 1,
    "205": 2,
    "206": 1,
    "207": 1,
    "208": 2,
    "209": 1,
    "210": 2,
    "211": 1,
    "212": 2,
    "213": 1,
    "214": 1,
    "215": 1,
    "216": 1,
    "217": 2,
    "218": 1,
    "219": 2,
    "220": 1,
    "221": 2,
    "222": 1,
    "223": 1,
    "224": 2,
    "225": 1,
    "226": 1,
    "227": 1,
    "228": 1,
    "229": 2,
    "230": 3,
    "231": 1,
    "232": 2,
    "233": 2,
    "234": 1,
    "235": 1,
    "236": 1,
    "237": 1,
    "238": 1,
    "239": 1,
    "240": 1,
    "241": 1,
    "242": 2,
    "243": 1,
    "244": 1,
    "245": 1,
    "246": 1,
    "247": 2,
    "248": 3,
    "249": 1,
    "250": 1,
    "251": 1
}
